0  0  0  0  0  0  0  0  0  0  0  0  0  0  0  0  0  0  0  0  10 10 10 10 10 10 10 0  0  0  10 10 10 10 0  0  0  0  0  0  0  0  10 0  0  0  0  0  10 0  0  0  10 0  0  0  10 10 10 10 10 10 10 10 0  0  10 0  0  0  0  0  10 0  0  0  0  0  0  0  0  0  0  10 10 10 10 10 0  0  0  0  0  0  0  0  0  0  10 10 10 10 10 0  0  0  10 10 10 10 10 10 10 0  0  0  10 10 10 10 10 10 10 0  0  0  0  7  1  1  1  1  1  1  1  1  1  1  1  9  0  0  0  0  0  0  0  0  0  0  0  0  0  0  0  0  0  0  0  0  0  0  0  0  0  0  0  0  0  0  0  0  0  0  0  0  0  0  0  0  0  0  0  0  0  0  0  0  0  0  0  0  0  0  0  0  0  0  0  0   
2  2  0  0  0  0  0  0  0  0  0  0  0  0  0  0  0  0  0  0  0  0  0  10 0  0  0  0  0  0  10 0  0  0  10 0  0  0  0  0  0  0  10 0  0  0  0  0  10 0  0  0  10 0  0  0  0  0  0  0  0  0  0  0  0  0  0  0  0  0  0  0  0  0  0  0  0  0  0  0  0  0  0  0  0  10 0  0  0  0  0  0  0  0  0  0  0  0  0  0  10 0  0  0  0  0  0  0  0  0  0  0  0  0  0  0  0  0  0  0  0  0  0  0  0  0  0  0  7  1  1  1  1  1  1  1  1  1  9  0  0  0  0  0  0  0  0  0  0  0  0  0  0  0  0  0  0  0  0  0  0  0  0  0  0  0  0  0  0  0  0  0  0  0  0  0  0  0  0  0  0  0  0  0  0  0  0  0  0  0  0  0  0  0  0  0  0  0  0  0  
0  0  0  0  0  0  0  0  0  0  0  0  0  0  0  0  0  0  0  0  0  0  0  10 0  0  0  0  0  0  10 0  0  0  0  10 0  0  0  0  0  0  0  0  0  0  0  0  0  0  0  0  0  0  0  0  0  0  0  0  0  0  0  0  0  0  0  0  0  0  0  0  0  0  0  0  0  0  0  0  0  0  0  0  0  10 0  0  0  0  0  0  0  0  0  0  0  0  0  0  10 0  0  0  0  0  0  0  0  0  0  0  0  0  0  0  0  0  0  0  0  0  0  0  0  0  0  0  0  7  1  1  1  1  1  1  1  9  0  0  0  0  0  0  0  0  0  0  0  0  0  0  0  0  0  0  0  0  0  0  0  0  0  0  0  0  0  0  0  0  0  0  0  0  0  0  0  0  0  0  0  0  0  0  0  0  0  0  0  0  0  0  0  0  0  0  0  0  0  0  
0  0  0  0  0  0  0  0  0  0  0  0  0  0  0  0  0  0  0  0  0  0  0  0  0  0  0  0  0  0  10 0  0  0  0  10 0  0  0  0  0  0  0  0  0  0  0  0  0  0  0  0  0  0  0  0  0  0  0  0  0  0  0  0  0  0  0  0  0  0  0  0  0  0  0  0  0  0  0  0  0  0  0  0  0  0  0  0  0  0  0  0  0  0  0  0  0  0  0  0  0  0  0  0  0  0  0  0  0  0  0  0  0  0  0  0  0  0  0  0  0  0  0  0  0  0  0  0  0  0  7  5  5  5  5  5  9  0  0  0  0  0  0  0  0  0  0  0  0  0  0  0  0  0  0  0  0  0  0  0  0  0  0  0  0  0  0  0  0  0  0  0  0  0  0  0  0  0  0  0  0  0  0  0  0  0  0  0  0  0  0  0  0  0  0  0  0  0  0  0  
0  0  0  0  0  0  0  0  0  0  0  0  0  0  0  0  0  0  0  0  0  0  0  0  0  0  0  0  0  0  10 0  0  0  0  0  0  0  0  0  0  0  0  0  0  0  0  0  0  0  0  0  0  0  0  0  0  0  0  0  0  0  0  0  0  0  0  0  0  0  0  0  0  0  0  0  0  0  0  0  0  0  0  0  0  0  0  0  0  0  0  0  0  0  0  0  0  0  0  0  0  0  0  0  0  0  0  0  0  0  0  0  0  0  0  0  0  0  0  0  0  0  0  0  0  0  0  0  0  0  0  0  0  0  0  0  0  0  0  0  0  0  0  0  0  0  0  0  0  0  0  0  0  0  0  0  0  0  0  0  0  0  0  0  0  0  0  0  0  0  0  0  0  0  0  0  0  0  0  0  0  0  0  0  0  0  0  0  0  0  0  0  0  0  0  0  0  0  0  0  
0  0  0  0  0  0  0  0  0  0  0  0  0  0  0  0  0  0  0  0  0  0  0  0  0  0  0  0  0  0  0  0  0  0  0  0  0  0  0  0  0  0  10 10 10 10 10 10 10 0  0  0  0  0  0  0  10 10 10 10 10 0  0  0  0  0  10 0  0  0  0  0  10 0  0  10 10 10 10 10 10 0  0  0  0  0  0  0  0  0  0  10 10 10 10 10 10 0  0  0  0  0  0  0  0  0  10 10 10 10 10 10 10 0  0  0  0  0  10 10 10 10 10 0  0  0  0  0  0  0  0  0  0  0  0  0  0  0  0  0  0  0  0  0  0  0  0  0  0  0  10 10 0  0  0  2  2  2  2  2  2  2  2  2  2  2  2  2  2  0  0  0  0  0  0  0  0  0  0  0  0  0  0  0  0  0  0  0  0  0  0  0  0  0  0  0  0  0  0  12  
0  0  0  0  0  0  0  0  0  0  0  0  0  0  0  0  0  0  0  0  0  0  0  0  0  0  0  0  0  0  0  0  0  0  0  0  0  0  0  0  0  0  10 0  0  0  0  0  10 0  0  0  0  0  0  0  0  0  0  0  0  0  0  0  0  0  0  0  0  0  0  0  0  0  0  0  0  0  0  0  0  0  0  0  0  0  0  0  0  0  0  0  0  0  0  0  0  0  0  0  0  0  0  0  0  0  0  0  0  0  0  0  0  0  0  0  0  0  0  0  0  0  0  0  0  0  0  0  0  0  6  2  2  2  2  2  8  0  0  0  0  0  0  0  0  10 10 0  0  0  0  0  0  0  0  0  0  0  0  0  0  0  0  0  0  0  0  0  0  0  0  0  0  0  0  0  0  0  0  0  0  0  6  8  0  0  6  8  0  0  6  8  0  0  6  8  0  0  6  8  
0  0  0  0  0  0  0  0  0  0  0  0  0  0  2  2  2  2  2  0  0  0  0  10 0  0  0  0  0  0  0  0  0  0  0  10 0  0  0  0  10 0  10 0  0  0  0  0  10 0  0  0  10 0  0  0  0  0  0  0  0  0  0  0  0  0  0  0  0  0  0  0  0  0  0  0  0  0  0  0  0  0  0  0  0  10 0  0  0  0  0  0  0  0  0  0  0  0  0  0  10 0  0  0  0  0  0  0  0  0  0  0  0  0  0  0  0  0  0  0  0  0  0  0  0  0  0  0  0  6  1  1  1  1  1  1  1  8  0  0  0  10 10 0  0  0  0  0  0  0  0  0  0  0  0  0  0  0  0  0  0  0  0  0  0  0  0  0  0  0  2  2  0  0  0  0  0  0  0  0  0  0  4  3  0  0  4  3  0  0  4  3  0  0  4  3  0  0  4  3  
0  0  0  0  0  0  0  0  0  0  0  0  0  0  0  0  0  0  0  0  0  0  0  10 0  0  0  0  0  0  0  0  0  0  10 0  0  0  0  0  0  0  10 0  0  0  0  0  10 0  0  0  10 0  0  0  0  0  0  0  0  0  0  0  0  0  0  0  0  0  0  0  0  0  0  0  0  0  0  0  0  0  0  0  0  10 0  0  0  0  0  0  0  0  0  0  0  0  0  0  10 0  0  0  0  0  0  0  0  0  0  0  0  0  0  0  0  0  0  0  0  0  0  0  0  0  0  0  6  1  1  1  1  1  1  1  1  1  8  0  0  0  0  0  0  0  0  0  0  0  0  0  0  0  0  0  0  0  0  0  0  0  0  0  0  0  0  0  0  0  0  0  0  0  0  0  0  0  0  0  0  0  4  3  0  0  4  3  0  0  4  3  0  0  4  3  0  0  4  3  
0  0  0  0  0  0  2  2  2  2  2  0  0  0  0  0  0  0  0  0  0  0  0  10 0  0  10 0  0  0  10 10 10 10 0  0  0  0  10 0  0  0  10 0  0  0  0  0  10 0  0  0  10 0  0  0  10 10 10 10 10 10 10 10 0  0  10 10 10 10 10 10 10 0  0  0  0  0  0  0  0  0  0  10 10 10 10 10 0  0  0  0  0  0  0  0  0  0  10 10 10 10 10 0  0  0  10 10 10 10 10 10 10 0  0  0  10 10 10 10 10 10 10 0  0  0  0  6  1  1  1  1  1  1  1  1  1  1  1  8  0  0  0  0  0  0  0  0  0  0  0  0  0  0  0  0  0  0  0  0  0  0  0  0  0  0  0  0  0  0  0  0  0  0  2  2  2  2  2  2  0  0  4  3  0  0  4  3  0  0  4  3  0  0  4  3  0  0  4  3  